****************************************************************************************
*  *                         *                                                         *
*  *                         *                                                         *
*  *    *                    *    *                                                    *
*  *    *                    *    *                                                    *
*  *    *                    *    *                                                    *
*       *                         *                                                    *
*       *                         *                                                    *
*       *                         *                                                    *
*  *                         *                                                         *
*  *                         *                                                         *
*  *    *                    *    *                                                    *
*  *    *                    *    *                                                    *
*  *    *                    *    *                                                    *
*       *                         *                                                    *
*       *                         *                                                    *
*       *                         *                                                    *
*       *                         *                                                    *
*       *                         *                                                    *
****************************************************************************************