************************************************************
*  *                                                       *
*  *                                                       *
*  *    *                                                  *
*  *    *                                                  *
*  *    *                                                  *
*       *                                                  *
*       *                                                  *
*       *                                                  *
*  *                                                       *
*  *                                                       *
*  *    *                                                  *
*  *    *                                                  *
*  *    *                                                  *
*       *                                                  *
*       *                                                  *
*       *                                                  *
************************************************************